7 10
##########
#S...#...#
#.#.#.##.#
#.#...#..#
#.###.##.#
#....#...#
###E######
